R 800 600     
NO ./textures/noxpm.xpm
SO ./textures/paul.xpm
WE ./textures/wexpm.xpm
EA ./textures/eaxpm.xpm
S ./textures/pillar.xpm
F 0,45,170
C 49,91,31

1111111111111111111111111
1000000000000000000000001
1000000000000000000000001
1000000000000000000000001
1000000111111000000000001
1000000100001000000000001
10000001000W1000000000001
1000000100001000000000001
1000001111111000001111111
1000000000000000000000001
1000000000000000000000001
1000000000000000000000001
1000000000000000000000001
1000000000000000000000001
1000000000000000000000001
1000000000000000000000001
1111111111111100000000001
1100000000000000000000001
1100000000000000000000001
1100000000000000000111111
1111111111000000000000001
1000000000000000000000001
1000000000000000000000001
1000000000000000000000001
1000000000000000000000001
1111111111111111111111111