R 800 600
NO ./textures/noxpm.xpm
SO ./textures/soxpm.xpm
WE ./textures/wexpm.xpm
EA ./textures/eaxpm.xpm
F 0,      80   , 80
C 89, 91, 131

1111111111111111111111111
1000000000000000000000001
1000000000000000000000001
1000000000000000000000001
1000000222220000000303031
1000000200020000000000001
1000000200020000000300031
1000000200020000000000001
1000000220220000000333331
1000000000000000000000001
1000000000000000000000001
1000000000000N00000000001
1000000000000000000000001
1000000000000000000000001
1000000000000000000000001
1000000000000000000000001
1333333333333300000000001
1304000020000000000000001
1200001020000000000000001
1204000020000000000000011
1222222222000000000000001
1000000000000000000000001
1222222220000000000000001
1222222220000000000000001
1222222220000000000000001
1111111111111111111111111