R 1920 1080
NO ./textures/noxpm.xpm
SO ./textures/soxpm.xpm
WE ./textures/wexpm.xpm
EA ./textures/eaxpm.xpm
F      250,      80   , 80
C 225,30,0
        1111111111111111111111111
        1000000000110000000000001
        1011000001110000002000001
        1001000000000000000000001
111111111011000001110000000000001
100000000011000001110111111111111
11110111111111011100000010001
11110111111111011101010010001
11000000110101011100000010000
10002000000000001100000010001
10000000000000001101010010001
11000001110101011111011110N0111
11110111 1110101 101111010001
1111111111 1111111111 11111111111111111111