R 1920 1080
NO ./textures/noxpm.xpm
SO ./textures/soxpm.xpm
WE ./textures/wexpm.xpm
EA ./textures/eaxpm.xpm
F      250,      80   , 80

C 225,30,0
1111111111111111111111111
1000000000110000000000001
1111000001110000000000001
1001000000000000000000001
1111111011000001110000001
1000000110000011101111111
1111011111111101110110001
1111011111111101110100001
1100000011010101110000001
1000100000200000110000001
1000000000000001101000201
11000001110101011100N0111
1111011111110101111010001
1111111111111111111111111