R 640 480
NO ./textures/noxpm.xpm
SO ./textures/soxpm.xpm
WE ./textures/wexpm.xpm
EA ./textures/eaxpm.xpm
F 0,      80   , 80

C 225,30,0
111111111111111111111111
100000000000000000000001
100000000000000000000001
100000000000000000000001
100000222220000303030001
1000002000200N0000000001
100000200020000300030001
100000200020000000000001
110000001101010111000001
100010000020000011000001
100000000000000110000201
110000011101010110000111
111101111111010111010001
100010000020000011000001
100010000020000011000001
100010000020000011000001
100010000020000011000001
100000000000000000000001
100000111100000000000001
100000111100000000000001
100000111100000000000001
100000111100000000000001
100000111100000000000001
111111111111111111111111