R 1920 1080
NO ./textures/noxpm.xpm
SO ./textures/soxpm.xpm
WE ./textures/wexpm.xpm
EA ./textures/eaxpm.xpm
F 0,      80   , 80
C 225,30,0

1111111111111111111111111111111
1000000000000000000000000000001
1000000000000000000000000000001
1000000000000000000000000000001
1000002222200000003030300000001
1000002000200000000000000000001
1000002000200000003000300000001
1000002000200000000000000000001
1000002202200000003333300000001
1000000000000000000000000000001
1000000000000000000000000000001
10000000000000000000N0000000001
1000000000000000000000000000001
1000000000000000000000000000001
1000000000000000000000000000001
1000000000000000000000000000001
1111111111111100000000000000001
1304000020000000000000000000001
1200001020000000000000000000001
1204000020000000000000100000001
1222222222000000000000000000001
1400000000000000000000000000001
1222222220000000000000000000001
1222222220000000000000000000001
1222222220000000000000000000001
1222222220000000000000000000001
1111111111111111111111111111111