R 800 600
NO ./textures/noxpm.xpm
SO ./textures/soxpm.xpm
WE ./textures/wexpm.xpm
EA ./textures/eaxpm.xpm
F 0,      80   , 80
C 89, 91, 131

1111111111111111111111111
1000000000000000000000001
1000000000000000000000001
1000000000000000000000001
1000000111110000000303031
1000000100010000000000001
1000000100010000000300031
1000000100010000000000001
1000001100011000001111111
1000000000000000000000001
1000000000000000000000001
1000000000E00000000000001
1000000000000000000000001
1000000000000000000000001
1000000000000000000000001
1000000000000000000000001
1111111111111100000000001
1100000000000000000000001
1100000000000000000000001
1100000000000000000000011
1111111111000000000000001
1000000000000000000000001
1222222220000000000000001
1222222220000000000000001
1222222220000000000000001
1111111111111111111111111