R 800 600
NO ./textures/noxpm.xpm
SO ./textures/soxpm.xpm
WE ./textures/wexpm.xpm
EA ./textures/eaxpm.xpm
S ./textures/pillar.xpm
F 0,      80   , 80
C 89, 91, 131

1111111111111111111111111
1000000000000000000000001
1000000000000000000000001
1000000000000000000000001
1000000111110000002000001
1000000100010000000000001
1000000100010000000000001
1000000100010000000000001
1000001100011000001111111
1000000000000000020000001
1000000000000000000000001
1000000000N00000000002001
1000200000000000000000001
1000000000000000000000001
1000000000000000020000001
1000000000000000000000001
1111111111111100000000001
1100000000000000000000001
1100000000000000000000001
1100000000000000000111111
1111111111000000000000001
1000000000000000000000001
1000000000000000000000001
1000000000000000000000001
1000000000000000000000001
1111111111111111111111111