R 22800 98600     
NO ./textures/noxpm.xpm
SO     ./textures/paul.xpm
WE   ./textures/wexpm.xpm
EA ./textures/eaxpm.xpm
S ./textures/pillar.xpm
F 0,85,32
C 19,191,201
1111111111111111111111111
1000000000000000000000001
1000000000000000000000001
1000000000000000000000001
1000000111110000000000001
1000000100010000000000001
1000000100010000000000001
1000000100010000000000001
1000001100011000001111111
1000000000000000000000001
1000000000000000000000001
1000000000000000000020001
100000000000E000200000001
1000000000000000000002001
1000000000000000000000001
1000000000000000000000001
1111111111111100000000001
1100000000000000020000001
1100000000000000000000001
1100000000000000000111111
1111111111000000000000001
1000000000000000000000001
1000000000000000000000001
1000000000000000000000001
1000000000000000000000001
1111111111111111111111111