R 800 600
NO ./textures/noxpm.xpm
SO ./textures/paul.xpm
WE ./textures/wexpm.xpm
EA ./textures/eaxpm.xpm
S ./textures/pillar.xpm
F 0,80,80
C 225,216,0

        1111111111111111111111111
        1000000000110000000000001
        1011000001110000002000001
        1001000000000000000000001
111111111011000001110000000000001
100000000011000001110111111111111
11110111111111011100000000001
11110111111110101110101000001
110000001101010111000000W0001
10002000000000001100000000001
10000000000000001101010010001
110000011101010111110111100111
11110111 1110101 101111010001
11111111 1111111 111111111111